ocamlfind="/home/corse/.opam/default/bin/ocamlfind"
ocamlc="/usr/bin/ocamlc.opt"
ocamlopt="/usr/bin/ocamlopt.opt"
ocamlbuild="/home/corse/.opam/default/bin/ocamlbuild"
pkg_name="DecentMon"
pkg_version="1.3"
os_type="Unix"
system="linux"
architecture="amd64"
ccomp_type="cc"
ocaml_version="4.08.1"
standard_library_default="/usr/lib/ocaml"
standard_library="/usr/lib/ocaml"
bytecomp_c_compiler="x86_64-linux-gnu-gcc -O2 -fno-strict-aliasing -fwrapv -fPIC -D_FILE_OFFSET_BITS=64 -D_REENTRANT"
native_c_compiler="x86_64-linux-gnu-gcc -O2 -fno-strict-aliasing -fwrapv -D_FILE_OFFSET_BITS=64 -D_REENTRANT"
model="default"
ext_obj=".o"
ext_asm=".s"
ext_lib=".a"
ext_dll=".so"
default_executable_name="a.out"
systhread_supported="true"
prefix="/usr/local"
exec_prefix="$prefix"
bindir="$exec_prefix/bin"
sbindir="$exec_prefix/sbin"
libexecdir="$exec_prefix/libexec"
sysconfdir="$prefix/etc"
sharedstatedir="$prefix/com"
localstatedir="$prefix/var"
libdir="$exec_prefix/lib"
datarootdir="$prefix/share"
datadir="$datarootdir"
infodir="$datarootdir/info"
localedir="$datarootdir/locale"
mandir="$datarootdir/man"
docdir="$datarootdir/doc/$pkg_name"
htmldir="$docdir"
dvidir="$docdir"
pdfdir="$docdir"
psdir="$docdir"
findlib_version="1.9.3"
is_native="true"
suffix_program=""
rm="rm -f"
rmdir="rm -rf"
debug="true"
profile="false"
native_dynlink="true"
ocamlbuildflags=""
docs="true"
tests="false"
pkg_batteries="/home/corse/.opam/default/lib/batteries"
pkg_camlp4="/usr/lib/ocaml/camlp4"
ocamlprof="/usr/bin/ocamlprof"
